0 0 0 0 0 0 0 0 0 0 0 0 0 0
0 0 0 0 0 0 0 0 0 0 0 1 1 0
0 0 0 0 0 0 0 0 0 0 1 1 1 0
0 1 1 1 1 0 0 0 0 0 1 1 1 0
0 1 1 1 1 0 0 0 0 0 1 1 1 0
0 1 1 1 1 0 0 0 0 0 0 1 1 0
0 1 1 1 1 0 1 1 1 0 1 1 1 0
0 1 1 1 1 0 1 1 1 0 1 1 1 0
0 1 1 1 1 0 0 1 1 0 1 1 1 0
0 1 1 1 1 0 0 1 1 0 1 1 1 0
0 1 1 1 1 0 0 1 1 0 1 1 1 0
0 1 1 1 1 0 0 0 0 0 0 0 0 0
0 1 1 1 1 0 0 0 0 0 0 0 0 0
0 0 0 0 0 0 0 0 0 0 0 0 0 0
@
0 0 0 0 0 0 0 0 0 0 0 0 0 0
0 0 0 0 0 0 0 0 0 0 0 0 0 0
0 0 0 0 0 0 0 0 0 0 0 0 0 0
0 0 0 0 0 0 0 0 0 0 0 0 0 0
0 0 3 11 0 0 0 0 0 0 0 0 13 0
0 0 0 0 0 0 0 0 0 0 0 0 0 0
0 0 0 0 10 0 0 0 0 0 0 0 0 0
0 0 0 8 0 0 0 0 11 0 0 11 0 0
0 0 0 0 0 0 0 0 11 0 0 0 0 0
0 0 7 0 10 0 0 0 0 0 0 0 0 0
0 0 0 0 7 0 0 0 0 0 0 0 0 0
0 0 0 7 0 0 0 0 0 0 0 0 0 0
0 0 11 0 0 0 0 0 0 0 0 0 0 0
0 0 0 0 0 0 0 0 0 0 0 0 0 0
