0 0 0 0 0 0 0 0
0 0 0 0 0 0 0 0
0 0 142 142 143 142 0 0
0 0 143 140 140 143 0 0
0 0 143 140 140 143 0 0
0 0 142 142 143 142 0 0
0 0 0 0 0 0 0 0
0 0 0 0 0 0 0 0
@
-1 -1 -1 -1 -1 -1 -1 -1
-1 -1 -1 -1 -1 -1 -1 -1
-1 -1 0 0 0 2 -1 -1
-1 -1 3 3 2 2 -1 -1
-1 -1 3 3 2 2 -1 -1
-1 -1 3 3 1 1 -1 -1
-1 -1 -1 -1 -1 -1 -1 -1
-1 -1 -1 -1 -1 -1 -1 -1
@
-1 -1 -1 -1 -1 -1 -1 -1
-1 -1 -1 -1 -1 -1 -1 -1
-1 -1 2 1 0 0 -1 -1
-1 -1 2 1 1 0 -1 -1
-1 -1 2 2 1 2 -1 -1
-1 -1 1 2 2 2 -1 -1
-1 -1 -1 -1 -1 -1 -1 -1
-1 -1 -1 -1 -1 -1 -1 -1
@
0 0 0 0 0 0 0 0
0 0 0 0 0 0 0 0
0 0 0 0 0 0 0 0
0 0 3 0 10 0 0 0
0 0 0 10 0 0 0 0
0 0 0 0 0 0 0 0
0 0 0 0 0 0 0 0
0 0 0 0 0 0 0 0
@
-1 -1 -1 -1 -1 -1 -1 -1
-1 -1 -1 -1 -1 -1 -1 -1
-1 -1 -1 -1 -1 -1 -1 -1
-1 -1 -1 -1 -1 -1 -1 -1
-1 -1 -1 -1 -1 -1 -1 -1
-1 -1 -1 -1 -1 -1 -1 -1
-1 -1 -1 -1 -1 -1 -1 -1
-1 -1 -1 -1 -1 -1 -1 -1
@
@
7 5 ; 7 7 ; 7 9 ; 7 11 ; 7 13 ; 7 15 ; 7 17 ; 9 17 ; 11 17 ; 13 17 ; 15 17 ; 15 19 ; 15 21 ; 13 21 ; 11 21 ; 9 21 ; 7 21 ; 7 19 ; 7 17 ; 7 15 ; 7 13 ; 7 11
