0 0 0 0 0 0 0 0 0 0 0 0
0 0 0 0 0 0 0 0 0 0 0 0
0 0 142 143 143 143 142 0 0 0 0 0
0 0 143 140 140 141 142 0 0 0 0 0
0 0 143 140 140 143 0 0 0 0 0 0
0 0 143 140 140 143 0 0 0 0 0 0
0 0 143 140 140 143 0 142 143 142 0 0
0 0 142 143 143 142 0 143 140 143 0 0
0 0 0 0 0 0 0 142 143 142 0 0
0 0 0 0 0 0 0 0 0 0 0 0
0 0 0 0 0 0 0 0 0 0 0 0
@
-1 -1 -1 -1 -1 -1 -1 -1 -1 -1 -1 -1
-1 -1 -1 -1 -1 -1 -1 -1 -1 -1 -1 -1
-1 -1 0 0 0 0 2 -1 -1 -1 -1 -1
-1 -1 3 1 1 1 1 -1 -1 -1 -1 -1
-1 -1 3 3 3 2 -1 -1 -1 -1 -1 -1
-1 -1 3 1 1 2 -1 -1 -1 -1 -1 -1
-1 -1 3 1 1 2 -1 0 0 2 -1 -1
-1 -1 3 1 1 1 -1 3 3 2 -1 -1
-1 -1 -1 -1 -1 -1 -1 3 1 1 -1 -1
-1 -1 -1 -1 -1 -1 -1 -1 -1 -1 -1 -1
-1 -1 -1 -1 -1 -1 -1 -1 -1 -1 -1 -1
@
-1 -1 -1 -1 -1 -1 -1 -1 -1 -1 -1 -1
-1 -1 -1 -1 -1 -1 -1 -1 -1 -1 -1 -1
-1 -1 0 1 0 2 0 -1 -1 -1 -1 -1
-1 -1 2 2 1 0 1 -1 -1 -1 -1 -1
-1 -1 2 1 0 2 -1 -1 -1 -1 -1 -1
-1 -1 2 0 1 0 -1 -1 -1 -1 -1 -1
-1 -1 1 1 0 1 -1 1 2 1 -1 -1
-1 -1 1 1 2 0 -1 0 1 1 -1 -1
-1 -1 -1 -1 -1 -1 -1 2 1 0 -1 -1
-1 -1 -1 -1 -1 -1 -1 -1 -1 -1 -1 -1
-1 -1 -1 -1 -1 -1 -1 -1 -1 -1 -1 -1
@
0 0 0 0 0 0 0 0 0 0 0 0
0 0 0 0 0 0 0 0 0 0 0 0
0 0 0 0 0 0 8 0 0 0 0 0
0 0 3 0 0 0 0 0 0 0 0 0
0 0 0 10 0 0 0 0 0 0 0 0
0 0 0 0 0 0 0 0 0 0 0 0
0 0 0 0 0 0 0 0 0 0 0 0
0 0 0 0 10 0 0 0 13 0 0 0
0 0 0 0 0 0 0 0 0 0 0 0
0 0 0 0 0 0 0 0 0 0 0 0
0 0 0 0 0 0 0 0 0 0 0 0
@
-1 -1 -1 -1 -1 -1 -1 -1 -1 -1 -1 -1
-1 -1 -1 -1 -1 -1 -1 -1 -1 -1 -1 -1
-1 -1 -1 -1 -1 -1 -1 -1 -1 -1 -1 -1
-1 -1 -1 -1 -1 -1 -1 -1 -1 -1 -1 -1
-1 -1 -1 -1 -1 -1 -1 -1 -1 -1 -1 -1
-1 -1 -1 -1 -1 -1 -1 -1 -1 -1 -1 -1
-1 -1 -1 -1 -1 -1 -1 -1 -1 -1 -1 -1
-1 -1 -1 -1 -1 -1 -1 -1 -1 -1 -1 -1
-1 -1 -1 -1 -1 -1 -1 -1 -1 -1 -1 -1
-1 -1 -1 -1 -1 -1 -1 -1 -1 -1 -1 -1
-1 -1 -1 -1 -1 -1 -1 -1 -1 -1 -1 -1
