0 70
@
0 0 0 0 0 0 0 0 0 0 0
0 0 0 0 0 0 0 0 0 0 0
0 0 0 142 142 0 0 0 0 0 0
0 0 0 143 141 142 0 0 0 0 0
0 0 142 141 140 143 0 0 0 0 0
0 0 143 140 140 143 0 0 0 0 0
0 0 142 141 141 142 0 0 0 0 0
0 0 0 142 142 0 142 143 142 0 0
0 0 0 0 0 0 143 140 143 0 0
0 0 0 0 0 0 142 143 142 0 0
0 0 0 0 0 0 0 0 0 0 0
0 0 0 0 0 0 0 0 0 0 0
@
-1 -1 -1 -1 -1 -1 -1 -1 -1 -1 -1
-1 -1 -1 -1 -1 -1 -1 -1 -1 -1 -1
-1 -1 -1 0 2 -1 -1 -1 -1 -1 -1
-1 -1 -1 3 2 2 -1 -1 -1 -1 -1
-1 -1 0 0 3 2 -1 -1 -1 -1 -1
-1 -1 3 3 3 2 -1 -1 -1 -1 -1
-1 -1 3 3 1 1 -1 -1 -1 -1 -1
-1 -1 -1 3 1 -1 0 0 2 -1 -1
-1 -1 -1 -1 -1 -1 3 3 2 -1 -1
-1 -1 -1 -1 -1 -1 3 1 1 -1 -1
-1 -1 -1 -1 -1 -1 -1 -1 -1 -1 -1
-1 -1 -1 -1 -1 -1 -1 -1 -1 -1 -1
@
-1 -1 -1 -1 -1 -1 -1 -1 -1 -1 -1
-1 -1 -1 -1 -1 -1 -1 -1 -1 -1 -1
-1 -1 -1 1 2 -1 -1 -1 -1 -1 -1
-1 -1 -1 1 1 2 -1 -1 -1 -1 -1
-1 -1 2 1 1 0 -1 -1 -1 -1 -1
-1 -1 0 0 1 1 -1 -1 -1 -1 -1
-1 -1 0 1 2 0 -1 -1 -1 -1 -1
-1 -1 -1 1 1 -1 2 1 0 -1 -1
-1 -1 -1 -1 -1 -1 1 2 1 -1 -1
-1 -1 -1 -1 -1 -1 2 0 1 -1 -1
-1 -1 -1 -1 -1 -1 -1 -1 -1 -1 -1
-1 -1 -1 -1 -1 -1 -1 -1 -1 -1 -1
@
0 0 0 0 0 0 0 0 0 0 0
0 0 0 0 0 0 0 0 0 0 0
0 0 0 0 7 0 0 0 0 0 0
0 0 0 0 0 0 0 0 0 0 0
0 0 3 0 0 0 0 0 0 0 0
0 0 0 0 10 0 0 0 0 0 0
0 0 7 0 0 0 0 0 0 0 0
0 0 0 0 0 0 0 0 0 0 0
0 0 0 0 0 0 0 13 0 0 0
0 0 0 0 0 0 0 0 0 0 0
0 0 0 0 0 0 0 0 0 0 0
0 0 0 0 0 0 0 0 0 0 0
@
-1 -1 -1 -1 -1 -1 -1 -1 -1 -1 -1
-1 -1 -1 -1 -1 -1 -1 -1 -1 -1 -1
-1 -1 -1 -1 -1 -1 -1 -1 -1 -1 -1
-1 -1 -1 -1 -1 -1 -1 -1 -1 -1 -1
-1 -1 -1 -1 -1 -1 -1 -1 -1 -1 -1
-1 -1 -1 -1 -1 -1 -1 -1 -1 -1 -1
-1 -1 -1 -1 -1 -1 -1 -1 -1 -1 -1
-1 -1 -1 -1 -1 -1 -1 -1 -1 -1 -1
-1 -1 -1 -1 -1 -1 -1 -1 -1 -1 -1
-1 -1 -1 -1 -1 -1 -1 -1 -1 -1 -1
-1 -1 -1 -1 -1 -1 -1 -1 -1 -1 -1
-1 -1 -1 -1 -1 -1 -1 -1 -1 -1 -1
